--------G
---------
---------
-XXXXXXXX
---------
---S-----
