-------XG
--X----X-
S-X----X-
--X------
-----X---
---------
