--------G
---------
---------
XXXXXXXX-
---------
---S-----
