--------G
---------
---------
-XXXXXXX-
---------
---S-----
